11111111111111111111111111111111111111
1P010000000100000000000000000000000001
10000000000100000011111111100000000001
10010000000100000010000001111C00000001
10000011111111100010000000011C00000001
10010000000000000010000000000111000001
10000C00010000000010000000000000000001
11111111111111111110000000000000000001
10000000000000000000000000C00000000001
100000000100111111111100000000000C0001
10000111100000000000C00000000100000001
10000000C11111000000000000000100000001
1000000000001111000000C000000100000001
100000000C00000000C0000000000100000001
10000011111110001000000000000100000001
100000000000000010000000000C0100000001
10000000000000001000000000000100000001
10000000010000001000000000000100000001
10000000000000001000000011111111111111
10000000000000001000000010000100000001
100000000C0000001000000010000001000001
100000000000000010000000000001000C00E1
11111111111111111111111111111111111111