11111111111111111111
1P010000000000000001
1001000010C000111001
10000C00100000C000E1
11111111111111111111
